Label=Package
Block Blast!=com.block.juggle
Canvas=com.instructure.candroid
ChatGPT=com.openai.chatgpt
Chrome=com.android.chrome
Coursera=org.coursera.android
Docs=com.google.android.apps.docs.editors.docs
DuckDuckGo=com.duckduckgo.mobile.android
Galaxy Shop=com.samsung.android.galaxy
Galaxy Store=com.sec.android.app.samsungapps
Gemini=com.google.android.apps.bard
Gmail=com.google.android.gm
Google Play Store=com.android.vending
LinkedIn=com.linkedin.android
Ludo King=com.ludo.king
Lufthansa=com.lufthansa.android.lufthansa
Maps=com.google.android.apps.maps
Meet=com.google.android.apps.tachyon
Messages=com.google.android.apps.messaging
OneDrive=com.microsoft.skydrive
Perplexity=ai.perplexity.app.android
Pinterest=com.pinterest
Samsung TV Plus=com.samsung.android.tvplus
spacedesk=ph.spacedesk.beta
WhatsAppÂ Business=com.whatsapp.w4b
YouTube=com.google.android.youtube
Snapchat=com.snapchat.android
Camera=com.sec.android.app.camera
Clock=com.sec.android.app.clockpackage
Samsung News=com.samsung.android.app.spage
Voice Recorder=com.sec.android.app.voicenote
Gallery=com.sec.android.gallery3d
Samsung Health=com.sec.android.app.shealth
Smart Switch=com.sec.android.easyMover
Contacts=com.samsung.android.app.contacts
Messages=com.samsung.android.messaging
Settings=com.android.settings
My Files=com.sec.android.app.myfiles
Calendar=com.samsung.android.calendar
Link to Windows Service=com.samsung.android.mdx
Calculator=com.sec.android.app.popupcalculator
Samsung Members=com.samsung.android.voc
Samsung Internet=com.sec.android.app.sbrowser
Samsung Notes=com.samsung.android.app.notes
Phone=com.samsung.android.dialer
Google=com.google.android.googlequicksearchbox
Instagram=com.instagram.android
